5 4 0 4 60.000000
0 0 0 0 1 0 0 0 0 0 
3 0 0 0 3 0 0 0 3 0 
1 0 0 0 0 0 0 0 1 0 
0 0 0 0 0 0 0 0 0 0 
0 0 0 0 1 0 3 0 0 0 
