5 4 1 4 10.000000
1 0 0 0 1 0 0 0 0 0 
3 0 0 0 3 0 0 0 3 0 
0 0 0 0 0 0 0 0 1 0 
0 0 2 1 0 0 0 0 0 0 
0 0 0 0 1 0 3 0 0 0 
