5 4 1 3 235.000000
0 0 3 0 0 0 0 0 1 0 
0 0 0 0 2 1 0 0 0 0 
1 0 0 0 3 0 0 0 1 0 
0 0 0 0 0 0 0 0 3 0 
0 0 1 0 0 0 0 0 0 0 
