5 4 2 2 60.000000
0 0 1 0 0 0 1 0 0 0 
0 0 0 0 0 0 1 0 0 0 
0 0 2 2 3 0 3 0 0 0 
0 0 0 0 2 1 0 0 0 0 
0 0 0 0 0 0 1 0 0 0 
