5 4 0 4 235.000000
1 0 0 0 1 0 0 0 0 0 
3 0 0 0 3 0 0 0 3 0 
0 0 0 0 0 0 0 0 1 0 
0 0 0 0 0 0 0 0 0 0 
0 0 0 0 1 0 3 0 0 0 
